Year,"Capital Cost",O&M,"Total Cost",Revenue,"Net Benefit/Loss",NPV
1,30,0,30,0,-30,($1.72)
2,30,0,30,0,-30,($1.72)
3,40,0,40,0,-40,($1.72)
4,,4,4,20,16,($1.72)
5,,5,5,25,20,($1.72)
6,,5,5,30,25,($1.72)
7,,6,6,35,29,($1.72)
8,,6,6,40,34,($1.72)
9,,7,7,45,38,($1.72)
10,,7,7,50,43,($1.72)
Total,100,40,140,245,105,($1.72)