Year,Capital Cost,O&M,Total Cost,Revenue,"NetBenefit/Loss", NPV
1,30,0,30,0,-30,$18.78
2,30,0,30,0,-30,$18.78
3,40,0,40,0,-40,$18.78
4,,4,4,20,16,$18.78
5,,5,5,25,20,$18.78
6,,5,5,30,25,$18.78
7,,6,6,35,29,$18.78
8,,6,6,40,34,$18.78
9,,7,7,45,38,$18.78
10,,7,7,50,43,$18.78
Total,100,40,140,245,105,$18.78